абрикос=apricot
абонент=subscriber
абитуриент=enrollee
абзац=paragraph
абсолютно=absolutely
абажур=shade
ажитация=agitation
ажур=openwork
азарт=excitement
азартно=recklessly
азбука=alphabet
азот=nitrogen
азотистый=nitrous
аист=stork
айсберг=iceberg
академик=academician
академический=academic
академия=academy
акация=acacia
акваланг=aqualung
аквалангист=aqualunger
аквамарин=aquamarine
аквамариновый=aquamarine
аквапарк=aquapark
акваплан=aquaplane
акварель=watercolor
акварельный=watercolor
аквариум=aquarium
акватория=waterarea
акведук=aqueduct
аккорд=accord
аккордеон=accordion
аккордеонист=accordionist
аккумулятор, батарея=battery
аккуратно=carefully
аккуратность=accuracy
аккуратный=careful
акрил=acrylic
акриловый=acrylic
акробат=acrobat
акробатика=acrobatics
акробатический=acrobatic
аксессуар=accessory
акт=act
актер=actor
актерский=actorish
актерство=acting
актив=assets
активатор=activator
активация=activation
активировать=activate
активист=activist
активно=energetically
активность=activity
актриса=actress
актуально=topically
актуальность=topicality
актуальный=actual
акула=shark
акустический=acoustic
акушер=obstetrician
акушерка=midwife
акушерский=obstetric, obstetrical
акушерство=obstetrics
акцент=accent
акцентировать=emphasize
акция=action
алгебра=algebra
алгебраический=algebraic
алгоритм=algorithm
алгоритмический=algorithmic
алебастр=alabaster
алебастровый=alabastrine
алкаш=boozer
алкоголизм=alcoholism
алкоголик=alcoholic
алкоголичка=alcoholic
алкоголь=alcohol
аллегорический=allegorical
аллегория=allegory
аллея=alley
аллилуйя=hallelujah
аллитерация=alliteration
алло=hulloa
алмаз=diamond
алмазный=diamond
алоэ=aloe
алтарь=altar
алфавит=alphabet
алфавитный=alphabetical
алхимик=alchemist
алхимический=alchemical
алхимия=alchemy
алчно=avidly
алчность=greed
алчный=greedy
алый=scarlet
алыча=alycha
альбом=album
альпинизм=mountaineering
альпинист=climber
альтернатива=alternative
альтернативный=alternative
альфонс=gigolo
алюминиевый=aluminum
алюминий=aluminum
амазонка=Amazon
амазонский=Amazonian
амбар=barn
амбициозность=ambition
амбиция=ambition
амеба=amoeba
аметист=amethyst
аминь=amen
амнезия=amnesia
аморфизм=amorphism
аморфный=amorphous
амплитуда=amplitude
амулет=amulet
амфибия=amphibian
амфора=amphora
анаконда=anaconda
аналептический=analeptic
анализ=analysis
анализатор=analyzer
анализирование=assaying
анализировать=analyze
аналитик=analyst
аналитический=analytical
аналог=analogue
аналогический=analogical
аналогичный=analogous
аналогия=analogy
ананас=pineapple
анархичный=anarchist
анархия=anarchy
анатомический=anatomical
анатомия=anatomy
ангар=hangar
ангел=angel
ангина=angina
английский=English
англичанин=Englishman
англичанка=Englishwoman
анекдот=joke
анестезиолог=anesthetist
анестезировать=anesthetize
анестезист=anesthetist
анестезия=anesthesia
анимационный=animated
анимация=animation
анкета=questionnaire
анкетирование=questionnaire
аннотация=annotation
ансамбль=ensemble
антивирус=virus
антидепрессант=antidepressant
античность=antiquity
античный=antique
антоним=antonym
антонимичный=antonymous
антракт=intermission
антураж=entourage
анчоус=anchovy
аншлаг=full house
апартамент=apartment
апатично=torpidly
апатичность=lethargy
апатичный=apathetic
апатия=apathy
апельсин=orange
аплодировать=applaud
аплодисменты=applause
апология=apology
апостроф=apostrophe
аппарат=machine
аппетит=appetite, stomach
аппетитный=appetizing
апрель=April
аптека=pharmacy
аптекарь=apothecary
аптечка=medicine chest
арбалет=crossbow
арбуз=watermelon
аргумент=argument
аргументация=argumentation
аренда=lease
арендатор=tenant
арендный=rent
арендовать=lease
арест=arrest
арестант=prisoner
арестованный=arrested
аристократ=aristocrat
аристократизм=aristocracy
аристократический=aristocratic
аритмичный=unrhythmical
аритмия=arrhythmia
арифметик=arithmetician
арифметический=arithmetic
арматура=fittings
армия=army
аромат=flavor
арсенал=arsenal
артист=artist
артистический=artistic
артистичность=artistry
арфа=harp
арфист=harper
археолог=archaeologist
археологический=archaeological
археология=archaeology
архив=archives
асимметричный=asymmetric
асимметрия=asymmetry
асимптота=asymptote
асинхронный=asynchronous
аспирант=graduate student
аспирин=aspirin
ассимиляционный=anabolic
ассимиляция=assimilation
ассистент=assistant
ассортимент=assortment
астероид=asteroid
астронавт=astronaut
астронавтика=astronautics
астрономический=astronomical
астрономия=astronomy
асфальт=asphalt
атаковать=attack
атаман=chieftain
атеист=atheist
ателье=studio
атлас=atlas
атлет=athlete
атлетика=athletics
атмосфера=atmosphere, ambience, air, ambiance, climate, aura
атмосферический=atmospheric
атрибут=attribute
атрофированный=atrophied, obsolete
атрофироваться=atrophy
аттестация=validation, performance review, performance evaluation
аттестовать=attest
аттракцион=attraction
аудиенция=audience
аудиосистема=audio system
аудитор=auditor
аудитория=audience
аукцион=auction, vendue, public sale
аукционист=auctioneer
афера=fraud
аферист=gambler
афиша=poster, placard, affiche, show bill, sticker, handbill, playbill
афишировать=advertise
аффект=affect
аффектация=affectation
аэробика=aerobics
аэробус=airbus, aerobus, jumbo jet, Airbus
аэровокзал=air terminal
аэродинамика=aerodynamics
аэродинамический=aerodynamic, airfoil, aerodynamical, aerofoil
аэродром=aerodrome, airfield, airdrome, air station, airstrip
аэрозоль=aerosol
аэроплан=airplane, aeroplane
аэропорт=airport
аэропочта=airmail
авангард=vanguard
аванс=advance
авантюрист=adventurer
аварийный=emergency, crash, trouble, wreck, jury, wreckage, troubleshooting
авария=accident
авеню=avenue
авиабаза=air base, air-base, airbase, air force base
авиабилет=airfare
авиакатастрофа=plane crash
авиалиния=airline
авианосец=aircraft carrier
авокадо=avocado
автобаза=motor depot
автобус=bus
автовокзал=bus station
автогонки=car race
автограф=autograph, signature
автография=autography
автодорога=highway
автодорожный=road transport
автодром=autodrome
автомобилист=motorist
автомобиль=car, vehicle, automobile, auto, motor vehicle, motor car, motor, machine
автомобильный=automotive
автор=author
авторский=authorial
авторство=authorship
автослесарь=car mechanician, car mechanic
автоспорт=motor racing
автостоянка=parking, car-park, car park, parking place, parking lot
автострада=motorway, highway, expressway, autostrada, autobahn, speedway, thruway
автострахование=car insurance
автоцентр=car center
агент=agent, envoy, emissary, courier, contact man, doer, promotion man, G-man
агентский=agential
агентство=agency
агитация=agitation, canvass, campaign activity
агитировать=agitate
агония=agony
аграрный=agrarian, predial, praedial
агрегат=unit, aggregate
агрессивность=aggressiveness, aggression, bellicosity, aggressivity
агрессивный=aggressive, invasive, offensive, belligerent, bellicose, truculent
агрессия=aggression
агрессор=aggressor
агроном=agronomist, agriculturist, agriculturalist, agronome
агрономический=agronomic, agronomical
агрономия=agronomy
агрофирма=agricultural company, agro company
агрохимия=agrochemistry
адаптация=adaptation, adapting, adaption
адаптер=adapter, adaptor
адаптивный=adaptive
адаптированный=adapted
адаптировать=adapt
адвокат=lawyer, attorney, counsel, advocate, solicitor, barrister, counselor
адвокатский=advocatory
адвокатура=advocacy
аддитивность=additivity
адекватность=adequacy, approximation
адекватный=adequate
административный=administrative, executive, managerial, executorial
администратор=administrator, manager, executive
администрация=administration
адмирал=admiral
адрес=address, superscription, adds
адресант=addresser

бабочка=butterfly
бабуля=granny
бабушка=grandmother
багаж=luggage, baggage, things, goods, Luggage, checked Luggage
багажник=trunk
багет=baguette
багрянец=purple
бадминтон=badminton
базальт=basalt
базальтовый=basaltic
базар=market
базилик=basil
базировать=base
базироваться=be based
базис=basis, base, datum-line, baseline
базисный=basic
байдарка=kayak, canoe
байдарочный=canoeing, canoe, kayak
байка=baize
байкер=biker
байт=byte
бакалавр=bachelor
баклажан=eggplant, aubergine, brinjal, guinea squash, egg-plant
баклан=gannet, cormorant
бактериальный=bacterial
бактерия=bacterium
балаган=farce, booth, carrousel, tomfoolery, carousel
балаганный=farcical
балалайка=balalaika
баланда=skilly
баланс=balance, balance sheet, balance in hand, balance-sheet, pulpwood
балансер=balancer
балбес=bonehead, booby, mug, lardhead
балда=noodle
балет=ballet
балка=beam
балкон=balcony
балл=point, mark
баллада=ballad, ballade
балласт=ballast
баллон=balloon, cylinder, bulb, gas cylinder, bag, bomb, balloon tire, can
баллончик=can, container, aerosol, spray can
баллотировать=ballot
баловать=indulge, pamper, spoil, pet, coddle, cosset, cosher, dandle, grandmother
баловаться=piddle
бамбук=bamboo
бампер=bumper
банальность=commonplace, banality, platitude, triviality, humdrum, triteness
банальный=banal, commonplace, trite, corny, trivial, hackneyed, obvious, quotidian
банан=banana
банда=gang
бандероль=wrapper
бандит=bandit, gangster, thug, gunman, mobster, brigand, outlaw, ruffian, tough
бандитизм=banditry, gangsterism, thuggery, brigandage, racketeering, gang violence
бандура=pandora
банк=bank, banker, jackpot, kitty, banking house, bankers, banking-house, pot
банкет=banquet
банкир=banker, Lombard, money agent
банкирский=banking, banker
банкнот=bill
баннер=banner
банька=bathhouse, bath, sauna
баня=bath, bathhouse, baths, vaporarium, bath-house, balneum, sauna
баобаб=baobab
бар=bar, cafe, saloon, tavern, barroom, taproom, tap house, gin mill
барабан=drum
барабанщик=drummer
барабулька=surmullet
баран=ram
баратея=barathea
барахолка=flea market, rag fair
барахольщик=magpie
барбекю=barbecue
бардак=mess
барельеф=low relief, bas-relief, bass-relief, bas relief
баржа=barge
баркан=lasso
бармен=bartender
барокко=baroque
барометр=barometer
барсук=badger
бархат=velvet
барыня=lady
барьер=barrier
баскетбол=basketball
баскетболист=basketball player
басня=fable
бассейн=pool, swimming pool
бастовать=strike, go on strike, be on strike, be out, on strike
бастующий=striker
батальон=battalion
батарейка=battery
батик=batic
батискаф=bathyscaphe, bathyscaph
батист=cambric
батометр=bathometer
батон=long loaf
батончик=stick of confectionery
батут=trampoline
бахилы=shoe covers
бацилла=bacillus
бациллярный=bacillary, bacilliform
бачок=tank
башенка=turret, pepperbox, mirador, pinnacle, small tower, little tower
башмак=shoe, boot, chock, clog, scotch, pressing shoe
башмачник=shoemaker, cobbler
башня=tower
баян=accordion
баянист=accordionist
бдение=vigil, wakefulness
бдительность=vigilance, alertness, look-out
бдительный=vigilant
беганье=running
бегать=run, shin, run about, run after, jog, chase
бегемот=hippopotamus, behemoth, river-horse
беглец=fugitive
бегство=escape
бегун=runner
бедно=humbly, meanly, shabbily
бедность=poverty, poorness, misery, indigence, penury, want, bareness, tenuity
беднота=poor
бедокур=mischief
бедолага=pilgarlic
бедствие=disaster, distress, scourge, calamity, evil, affliction, plague, curse
бедствовать=live in poverty
безветрие=calm
безвинный=innocent
безвкусие=insipidity, insipidness
безвкусица=raunch, flashiness, bad taste
безвкусно=flashily
безграничность=infinity
безделица=trifle, minim, fiddlededee
безделка=gaud
безделушка=bauble
бездна=abyss
бездомность=homelessness
бездомный=homeless
безжалостный=ruthless
беззаботность=carelessness, insouciance, unconcern, nonchalance
беззаботный=carefree
безликий=faceless, impersonal, featureless, milk-and-water
безликость=impersonality
безмолвие=silence, quiet, still
безмолвно=mutely
безнадежно=hopelessly, despairingly, irreparably
безнадежность=hopelessness
безнадежный=hopeless
безобидность=innocuity
безобидный=harmless
безобразно=disgustingly, beastly
безобразный=ugly
безопасно=safely, securely, with safety
безопасность=security, safety, safeness
безопасный=safe
безответственно=irresponsibly
безответственность=irresponsibility, irresponsive
безответственный=irresponsible
безошибочно=accurately, unmistakably, without mistakes, without error
безошибочность=accurateness, faultlessness
безошибочный=unmistakable
безразличие=indifference, apathy, unconcern, disinterest, nonchalance, insouciance
безразлично=indifferently, all the same
безразличный=indifferent
безумно=madly, deliriously, like fury, insanely
безумный=mad
безумство=madness, folly, desperation
безупречно=faultlessly, irreproachably
безупречность=perfection, impeccability, irreproachability, immaculacy, impeccancy
безупречный=irreproachable
безусловно=certainly, undoubtedly, absolutely, sure, positively, unconditionally
безусловность=absoluteness
безусловный=unconditional
бейсбол=baseball, ball, hardball
бейсболист=ballplayer
бейсболка=baseball cap
бекон=bacon
беление=whitening, bleaching, whiting, whitewashing
беленький=white
белиберда=rubbish
белка=squirrel
белье=linen, washing, wash, bedclothes, underwear, lingerie, clothes, undies
бельмо=albugo
бенефис=benefit
бензин=petrol
бензол=benzene, benzol, benzole, carbon oil
бензопила=gasoline saw
бергамот=bergamot
бережно=carefully
бережный=careful, cautious
береза=birch
беременеть=become pregnant
беременная=pregnant, expectant, gravid, enceinte, parturient, impregnated, preggers
беременность=pregnancy
беречь=protect, take care of, guard against, spare, beware
беречься=beware
берлога=lair
беседа=conversation
беседовать=talk
бесить=enrage, madden, drive wild
беситься=rage
бесконечно=infinitely
беспокоиться=worry, bother, trouble, concern, care, fret, fash, feeze, worrit, stew
беспокойно=discomposedly, uneasily
беспокойный=restless, troubled, hectic, troublesome, anxious, uneasy, turbulent
беспокойство=concern, anxiety, worry, trouble, bother, disturbance, unrest, disquiet
бесполезно=needlessly, without avail, no earthly use, it's no-good, it's useless
бесполезность=uselessness, futility, disutility, inutility, needlessness, vainness
бесполезный=useless
беспомощно=blankly, fecklessly, helplessly
беспомощность=impotence, feebleness, impotency, anemia, anaemia, helplessness
беспомощный=helpless
беспощадно=hip and thigh
беспощадность=mercilessness
беспощадный=merciless
беспредел=total lawlessness
беспредельный=boundless
беспрерывность=continuity, regularity
беспрестанный=continual
бессердечность=callousness, callosity
бессердечный=heartless
бесследно=without a trace
бессмысленно=vacantly, fatuously, no earthly reason, meaninglessly
бессмысленность=inanity, fatuity, foolishness, inanition, fatuousness, meaninglessness
бессмысленный=senseless, meaningless, mindless, pointless, wanton, nonsensical, blank
бессмыслица=nonsense
бессонница=insomnia, sleeplessness, wakefulness, vigilance, anhypnosis
бессонный=sleepless
бесстрашие=fearlessness, daring
бесстрашный=fearless
бесстыдно=obscenely, shamelessly
бесстыдный=shameless, brazen, impudent, immodest, barefaced, blatant, brassy, cynic
бесстыдство=impudence
бестактность=indelicacy, gaucherie, tastelessness, maladresse
бестактный=tactless
бестолковщина=muddle
бестолковый=stupid, goofy, obtuse, incoherent, gormless, cockeyed, footless
бестолочь=chowderhead
бесцветно=colorless, colourless, insipid, flat, tame, wan, achromic, tintless
бесцветность=insipidity
бесчувственность=insensibility, callousness, impassibility, rockiness
бесчувственный=unfeeling
бетон=concrete
бетонирование=concrete pouring, concrete casting
бетонировать=concrete
бетономешалка=concrete mixer
бешенство=rabies, rage, fury, frenzy, furiousness, madness, hydrophobia, rabidity
бешеный=rabid
библейский=biblical, scriptural, scripture
библиограф=bibliographer
библиографический=bibliographic, bibliographical
библиография=bibliography
библиотека=library
библиотекарь=librarian
библия=Bible
бивень=tusk
бигуди=curler
биде=bidet
бидон=can
бижутерия=bijouterie, imitation jewelry
бизнес=business, biz, BIZ
бизнесмен=businessman, business leader, business executive
бизон=buffalo
бикини=bikini
билет=ticket
биллборд=billboard
бинарный=binary
бинт=bandage, roller, swathe, fascia, roller-bandage
бинтование=bandaging
биограф=biographer
биографический=biographical, biographic
биография=biography
биолог=biologist
биологический, биологически=biological, biologic
биология=biology
биомасса=biomass
биомеханика=biomechanics
бионаука=bioscience
биополе=biological field
биопсия=biopsy
биоритм=biorhythm
биотопливо=biofuel
биохимический=biochemical
биохимия=biochemistry
биоэлектроника=bioelectronics
биоэнергетика=bioenergetics
биржа=exchange, burse, rialto, bourse
биржевик=speculator
биржевой=referring to exchange
бирка=tag
бирюза=turquoise
бисер=beads, bead, bugle, beadwork
бисерина=bead
бисквит=sponge cake
битва=battle
битый=beaten
бить=beat, hit, strike, smash, pound, pommel, bang, pummel, knock, thrash
битье=beating
бифштекс=steak
благо=good, boon, blessing, weal, welfare
благоверная=missus, wife
благоверный=pious
благородно=nobly, honorably, gallantly, knightly, greatly, honourably
благородный=noble, honorable, generous, genteel, knightly, exalted, elevated
благородство=nobility
блаженство=bliss, blessedness, beatitude, felicity, blessing, blissfulness
блаженствовать=luxuriate, blissfully happy
блажной=capricious, preposterous, eccentric
блажь=whim, maggot, extravagance
бланк=form, blank
блат=pull, profitable connections
блатной=rogue
блевать=barf, spew, cat, fetch up, ralph, spue, shoot the cat
блевотина=vomit, spew, spue
бледненький=poor, pitiable
бледнеть=turn pale
бледно=faintly
блеск=gloss
блестка=paillette, spangle, sequin
блестяще=brilliantly, bright
блеф=bluff
близкие=folks
близкий=close
блик=patch of reflected light, patch of light, highlight
бликовать=rejoice, exult, triumph
блин=pancake
блок=block, unit, bloc, pulley, sheave, pivot
блокада=blockade
блокатор=blocker
блокбастер=blockbuster
блокнот=notebook
блокпост=blockhouse
блоха=flea
блуд=fornication, whoredom, bastardy
блудить=fornicate, lecher, commit fornication
блудливый=lascivious, lecherous
блудница=whore
блузка, блуза=blouse
блюдечко=limpet, patellula, silver platter
блюдо=dish, course, platter, entree
блюдце=saucer
блюз=blues
бобр=beaver, castor
бобрик=frieze, Bobryk village
бобровый=beaver
богатей=rich man
богатеть=grow rich
богато=richly, prodigally, ornate
богатство=wealth, riches, richness, rich, fortune, opulence, abundance, affluence
богатый=rich, wealthy, affluent, abundant, opulent, full, plentiful, profuse
богатырский=heroic, giant, Herculean, athletic
богатырь=hero
богомол=mantis
бодать=bunt
бодрить=invigorate
бодро=freshly, pertly
бодрость=cheerfulness, courage, peppiness, good spirits, PEP
бодрствование=wake, vigil
бодрствовать=watch, be awake, keep vigil, sit up, keep watch
бодрый=cheerful
боевик=thriller
боец=fighter
бой=fight, battle, combat, fighting, action, boy, engagement, beat, breakage
бойкий=glib, jaunty, perky, pert, saucy
бойко=trippingly
бойня=massacre
бок=side, flank, hip, wall, side elevation, sidepiece, sideways
бокал=goblet
бокс=boxing, box, pugilism, boxcalf, bout with the gloves, manly art
боксер=boxer, pugilist, mauler, pug, sparrer, prize-fighter
боксировать=box
болван=boob, blockhead, doodle, loggerhead, dummy, dolt, nerd, booby, jackass
болванка=ingot
болезненно=painfully, morbidly
болезненность=soreness, morbidity, sickliness, morbidness, debility, valetudinarianism
болезненный=painful, morbid, sickly, diseased, sore, unhealthy, sick, wan, tender
болезнетворный=pathogenic
болезнь=disease, illness, sickness, ailment, malady, sick, affliction, complaint
болельщик=fan, rooter, buff, aficionado, addict, fandom, cheerleader
болеро=bolero
болеть=hurt
болотный=swamp, marshy, paludal, fenny, uliginous
болото=marsh
болтливость=gab, garrulity, loquacity, jaw
болтливый=chatty, talkative, garrulous, gossipy, gassy, mouthy, loquacious, windy
болтовня=chatter, talk, gossip, chitchat, babble, twaddle, chat, prattle, blather
болтун=chatterbox
боль=pain, hurt, ache, anguish, distress, complaint, pang, stab, headache
больница=hospital
больно=painfully, badly
больше=more
большинство=most, majority, many, major, better part, generality, most feck
большой=large
бомба=bomb
бомбардир=bombardier
бомбардировать=bombard
бомбардировка=bombardment, bombing, prang, plastering
бомбардировщик=bomber
бордовый=vinous
бордюр=border, frieze, edging, welt, skirting, curb, kerb, curbstone
бордюрный=curbstone
бормотать=mumble, mutter, murmur, babble, burble, jabber, patter, gabble, maunder
бормотун=gabbler
бородавка=wart, verruca
бородавник=nipplewort
бородавчатый=warty, papillose, verrucous
бородатый=bearded, barbate, bearded man
бородач=bearded man, beaver, bearded vulture, bearded fellow
бородка=barb
борщ=borscht,
ботаник=botanist
ботанический=botanic
ботинок=boot
боулинг=bowling, kegling
боцман=boatswain
бочка=barrel, cask, vat, butt, barrel roll, hogshead, wood, tierce, snap-roll
бочкообразный=tubby
бочок=flank
боярыня=noblewoman
боярышник=hawthorn, haw, whitethorn
боярышня=boyar
бояться=fear
браво=bravo
бравый=brave, gallant, dashing, courageous
бражник=roisterer
брак=marriage
браковать=cull, condemn
браковка=rejection, penalization
браковщик=passer
браконьер=poacher, pothunter
браконьерство=poaching
браслет=bracelet
брат=brother
братва=lads, chaps
братец=brer
братство=brotherhood
бревно=log, beam, timber, baulk, balk, balance beam
брег=running, race, horse-race, hiding
бред=rave
брезгливость=disgust, fastidiousness
брезгливый=squeamish, fastidious
брезговать=be squeamish
брезент=tarpaulin, canvas
брезентовый=canvas
брелок=trinket
бретелька=shoulder-strap
брехня=lies
бригада=brigade, team, crew, squad, brig
бригадир=brigadier
бриз=breeze
бриллиант=diamond
бритва=razor, shaver
бритвенный=shaving set
брить=shave, razor, shaving
бритье=shaving
бровь=eyebrow
бродить=wander, roam, ferment, prowl, ramble, stroll, walk around, rove, stray
бродяга=tramp
бродячий=wandering
бройлер=broiler
брокер=broker
брокколи=broccoli
бронебашня=cupola
бронебойный=armour-piercing
броневик=armored car
бронежилет=bulletproof vest, flak jacket, armor vest, armouring waistcoat
бронемашина=armored car
броненосец=ironclad, armadillo, armour-clad
броненосный=armored
бронза=bronze
бронирование=reservation
бронированный=armored, ironclad, mailed, panzer, shellproof, armoured, armour-clad
бронировать=armor
бронхит=bronchitis
бросать=throw
брошь=brooch, broach
брошюра=brochure
брусника=cowberry
брутальный=brutal
брызгать=splash
брызги=spray
брыкание=buck
брынза=feta cheese
брюки=trousers, pants, breeches, pantaloons, unmentionables, nether garments
брюнет=brunet
брюхатый=paunchy
брюхо=belly
бубен=tambourine
бугор=hillock
будда=Buddha, Buddhas
буддизм=Buddhism
будильник=alarm clock, daily alarm
будить=wake, awaken, awake, rouse, arouse, waken, rouse from, rouse out of
будка=booth, shack, cabin, cab, cope, kiosk
будни=weekdays, workaday routine, weekday, workday, workaday, everyday life
будний=ferial
будоражить=disturb
будущее=future
буй=buoy, float, beacon
буйвол=buffalo, bull, ox
буйно=violently
букашка=insect
буква=letter
буквально=literally, to the letter, literatim
буквальность=literality, letter
буквальный=literal, verbal, textual, diplomatic
букварь=primer
букет=bouquet
буклет=booklet
буксир=tow, tug, tugboat, tracker, tow-line, tow-rope, towing-line, towing-rope
буксирный=towing, tow, towline
буксирование=haulage
буксование=skidding, skid, slippage
буксовать=skid
буксовка=slip
булава=mace, club, Indian club
булавка=pin
булочка=bun, bap, cookie, cooky, wad, pikelet, brioche, muffin, bread roll
булочная=bakery
булочник=baker
булыжник=cobblestone
булыжник=cobblestone
бульдозер=bulldozer
бульканье=gurgling, gurgle, guggle, hubble-bubble
булькать=gurgle
бульон=bouillon, broth, clear soup
бультерьер=bull terrier, English bull terrier
бум=boom
бумага=paper
бумажник=wallet
бумеранг=boomerang
бункер=hopper, bunker
бунт=revolt, rebellion, riot, mutiny, insurrection, rebel
бунтарский=rebellious, seditious
бунтарь=rebel
бурбон=bourbon
бурно=roughly
бурность=turbulence
бурундук=chipmunk, hackee
бурчание=muttering, rumbling, grumbling, collywobbles
бурчать=mutter, grumble, mumble, bubble
бурый=brown, fulvous, lurid, lignite
бурьян=tall weeds
буря=storm
бусинка=bead
бутик=boutique
бутылка=bottle
буфет=buffet, sideboard, cupboard, canteen, cantina, refreshment room, kiosk
буфетная=pantry, scullery, still-room
буфетный=buffer, surge
буфетчик=barman
буханка=loaf
бухгалтер=accountant, bookkeeper, booker, book-keeper, accounting officer
бухгалтерия=bookkeeping
бухта=bay
бушевать=rage
бывший=former, ex, old, onetime, late, sometime, quondam, later, lapsed, latter
бык=bull
былой=erstwhile, onetime, olden, departed, lapsed
быль=true story
быстро=fast
быт=everyday, everyday life, living conditions, household activities
бытие=existence
бытовой=domestic, everyday
быть=be
бюджет=budget, budgeting
бюджетник=state employee
бюджетный=budgetary
бюллетень=bulletin, ballot-paper, newsletter, Gazette, ballot
бюргер=burgher
бюро=bureau, office, secretaire, writing-desk, Bureau
бюрократ=bureaucrat, bureaucracy
бюрократизация=bureaucracy
бюст=bust, bubs
бюстгальтер=bra

вовеки=forever
вовлечение=involvement, implication
вовлечь=drag in, ensnarl
вовлечься=get involved, involved, engage
вовне=outside, out there, out-
вовремя=in time, on schedule, early in the day
вовсе=any
водитель=driver, skinner
водительство=guidance
водить=conduct
водка=vodka
водоканал=water canal
водопад=waterfall, cascade, cataract, Niagara, linn
водопой=watering place
водород=hydrogen
водоросль=alga
военачальник=warlord, chieftain, military officer, army leader
военврач=surgeon
военкомат=recruitment office, rectal, enlistment office, military office
военнообязанный=reservist, liable for military service, bound to military service
военнопленный=prisoner of war, war prisoner
военнослужащий=serviceman, soldier, military servant, military officer, service member
военный=military
вожак=leader
возбуждать=excite, stir, bring, arouse, stir up, stimulate, incite, energize, rouse
возбуждаться=get excited, ferment, fluster
возбуждение=excitation, excitement, agitation, stimulation, incitement, exhilaration
возбужденно=heatedly
возврат=return, refund, recurrence, reclamation, throwback, payback, paid back
возвратимый=revertible
возвратиться=come again
возвышение=elevation
возгорание=ignition
возможно=perhaps, possibly, perchance, like, feasibly, peradventure, as possible
возможность=opportunity, possibility, potential, capacity, ability, chance, facility
возможный=possible
возникновение=emergence, origin, beginning, genesis, uprising, nascency, nascence
возникнуть=come into being
возраст=age, years, year
возрастание=increase
война=war, warfare, arms, sword
войско=army
вокалист=vocalist, musician
вокалистка=cantatrice
вокальный=vocal
вокзал=railway station
волк=wolf
волнение=excitement
волнорез=breakwater
волокно=fiber
волшебство=magic
вольер=aviary
вольность=liberty, freedom, licentiousness
вольный=free, liberal, licentious, freestyle
вольт=volt
вольтметр=voltmeter, voltage meter
вольфрам=tungsten
волюта=volute, helix
воля=will, freedom
вонь=stink, stench, reek, pong, fetor, niff, funk, hum, fetidity
вонючий=smelly, stinking, stinky, fetid, stunk, foul, putrid, malodorous, foetid
вонючка=skunk
вообще=at all, in general, generally, any, always, as a general rule
воодушевить=inspire, inspirit, mettle, reanimate, put on his mettle
воодушевление=inspiration, animation, go
воодушевлять=cheer
вор=thief
воровство=theft
воронка=funnel
ворчать=grumble
восемь=eight
восемьдесят=eighty, fourscore, eighties
восемьсот=eighteen hundred
воск=wax, beeswax, cobbler's wax, waxy
воскликнуть=exclaim
восклицание=exclamation
воспаление=inflammation, pneumonia
воспалительный=inflammatory, phlogistic
воспалить=inflame
воспевать=chant
воспитанность=breeding, mannerliness, good breeding, good manners
воспитанный=fostered, mannerly, civilized, civil, couth, gentlemanlike, gentlemanly
воспитатель=educator
восстание=uprising
восток=east
восторг=delight, enthusiasm, rapture, admiration, elation, exaltation, glory
восторгать=ravish
восхититься=admire, marvel, delight
восхищать=delight, marvel, enrapture, ravish, bewitch, entrance, rapture, admire
восхищаться=admire, delight, marvel
восхищение=admiration, delight, rapture, adoration, applause, ravishment
восход=rise
восьмиугольник=octagon
воспоминание=memory
воспринимать=perceive, receive, perceiving
восприятие=perception, reception, intussusception, misperception
воспроизведение=reproduction
восстать=turn against
впадина=cavity
впервые=first
впереди=ahead
впечатление=impression, impress, feeling, showing
впечатленный=impressed
впечатлить=impress
впитывание=absorption, soak, imbibition, adsorption
впитывать=soak
враг=enemy, foe, adversary, opponent, hostile
вражда=enmity
враждебно=with hostility, with animosity, with enmity
враждебность=hostility, animosity, enmity, animus, spite, ill blood
враждебный=hostile, enemy, inimical, antagonistic, adverse, opposed, rancorous
враждовать=feud
вранье=lies
вратарь=goalkeeper, keeper, goalie, goalee
врать=fib, tell lies, say lies
врач=doctor, physician, medic, hakeem, Aesculapius, hakim, practitioner
врачебный=medical
вращать=rotate
вредитель=pest, fly
вредительство=wrecking, sabotage
вредить=harm, wrong, blast, blemish, make mischief, scathe
вредность=insalubrity
временно=temporarily, temporally, transiently, pro tempora, provisionally
временной=temporal
вроде=like, as a sort, as a kind, sort of, something in the nature of
врожденный=congenital, innate, inherent, inborn, natural, inbred, connatural
врозь=apart
врун=liar
вручение=delivery, presentation, serving, commitment, committal, handle
вручную=manually
всегда=always
вселенная=universe, world, cosmos, macrocosm
вселенский=ecumenical
всемогущество=omnipotence, Almighty power
всемогущий=omnipotent
всерьез=seriously
всеядный=omnivorous
вскакивать=jump up
вслух=aloud, audibly, in the ears, in their hearing
вслушиваться=listen attentively
всматриваться=peer
всмятку=soft-boiled
вставать=get up, stand up, rise, arise, emerge, be about, wake up, get up again
вставка=insert, insertion, piece, gusset, inlet, intercalation, chemisette
вставление=insertion
встреча=meeting, meet, appointment, gathering, bout, reception, greeting, social
встречать=meet
вступать=enter, join, engage, enter into, go into, accede, come in
вступаться=intercede, intervene, stand up for
вступительный=opening
всякий=any
втирание=chafing, inunction, anatripsis, infriction
втирать=rub in
втолкнуть=push in
втроем=all three
втройне=threefold
втягивать=retract
вуалировать=veil
вуаль=veil
вулкан=volcano, eruption
вулканизатор=vulcanizer
вулканизация=vulcanization
вулканический=volcanic
вход=entry, entrance, login, inlet, admission, door, gate, ingress, gateway
входить=enter, login, go in, come in, walk in, get in, enter into, go into
входной=input, entrance, inlet, entry
вхождение=occurrence
вцепляться=hold on
вчера=yesterday
вшивать=sew in
